ㄹ ㄹ ㄹ ㄹ ㄹ ㄹ ㄹ ㄹ ㄹ ㄹ ㄹ ㄹ ㄹ ㄹ -> ㄹ ㄹ ㄹ ㄹ ㄹ ㄹ ㄹ ㄹ ㄹ ㄹ ㄹ ㄹ ㄹ ㄹ
ㅓ ㅓ ㅓ ㅓ ㅓ ㅓ ㅓ ㅓ ㅓ ㅓ ㅓ ㅓ ㅓ ㅓ -> ㅓ ㅓ ㅓ ㅓ ㅓ ㅓ ㅓ ㅓ ㅓ ㅓ ㅓ ㅓ ㅓ ㅓ
ㅇ ㅇ ㅇ ㅇ ㅇ ㅇ ㅇ ㅇ ㅇ ㅇ ㅇ ㅇ ㅇ ㅇ -> ㅇ ㅇ ㅇ ㅇ ㅇ ㅇ ㅇ ㅇ ㅇ ㅇ ㅇ ㅇ ㅇ ㅇ
ㅏ ㅏ ㅏ ㅏ ㅏ ㅏ ㅏ ㅏ ㅏ ㅏ ㅏ ㅏ ㅏ ㅏ -> ㅏ ㅏ ㅏ ㅏ ㅏ ㅏ ㅏ ㅏ ㅏ ㅏ ㅏ ㅏ ㅏ ㅏ
ㄹ ㅓ ㄹ ㅓ ㄹ ㅓ ㄹ ㅓ ㄹ ㅓ ㄹ ㅓ ㄹ ㅓ -> ㄹ ㅓ ㄹ ㅓ ㄹ ㅓ ㄹ ㅓ ㄹ ㅓ ㄹ ㅓ ㄹ ㅓ
ㅇ ㅓ ㅇ ㅏ ㅇ ㅓ ㅇ ㅏ ㅇ ㅓ ㅇ ㅏ ㅇ ㅓ -> ㅇ ㅓ ㅇ ㅏ ㅇ ㅓ ㅇ ㅏ ㅇ ㅓ ㅇ ㅏ ㅇ ㅓ
ㄹ ㅏ ㅇ ㅓ ㄹ ㅏ ㅇ ㅓ ㄹ ㅓ ㅇ ㅏ ㄹ ㅓ ㅇ ㅏ -> ㄹ ㅏ ㅇ ㅓ ㄹ ㅏ ㅇ ㅓ ㄹ ㅓ ㅇ ㅏ ㄹ ㅓ ㅇ ㅏ
러 러 러 러 러 러 러 러 러 러 러 러 러 러 -> 러 러 러 러 러 러 러 러 러 러 러 러 러 러
얼 얼 얼 얼 얼 얼 얼 얼 얼 얼 얼 얼 얼 얼 -> 얼 얼 얼 얼 얼 얼 얼 얼 얼 얼 얼 얼 얼 얼
아 아 아 아 아 아 아 아 아 아 아 아 아 아 -> 아 아 아 아 아 아 아 아 아 아 아 아 아 아

ㅎ ㅎ ㅎ ㅎ ㅎ ㅎ ㅎ ㅎ ㅎ ㅎ ㅎ ㅎ ㅎ ㅎ -> ㅎ ㅎ ㅎ ㅎ ㅎ ㅎ ㅎ ㅎ ㅎ ㅎ ㅎ ㅎ ㅎ ㅎ
ㅗ ㅗ ㅗ ㅗ ㅗ ㅗ ㅗ ㅗ ㅗ ㅗ ㅗ ㅗ ㅗ ㅗ -> ㅗ ㅗ ㅗ ㅗ ㅗ ㅗ ㅗ ㅗ ㅗ ㅗ ㅗ ㅗ ㅗ ㅗ
ㅎ ㅗ ㅎ ㅗ ㄹ ㅗ ㄹ ㅗ ㅎ ㅗ ㅎ ㅗ ㄹ ㅗ ㄹ ㅗ -> ㅎ ㅗ ㅎ ㅗ ㄹ ㅗ ㄹ ㅗ ㅎ ㅗ ㅎ ㅗ ㄹ ㅗ ㄹ ㅗ
허 허 호 호 호 호 허 허 호 호 호 호 허 허 -> 허 허 호 호 호 호 허 허 호 호 호 호 허 허
ㅇ ㄹ ㅎ ㅇ ㄹ ㅎ ㅇ ㄹ ㅎ ㅇ ㄹ ㅎ ㅇ ㄹ ㅎ -> ㅇ ㄹ ㅎ ㅇ ㄹ ㅎ ㅇ ㄹ ㅎ ㅇ ㄹ ㅎ ㅇ ㄹ ㅎ
ㅗ ㅓ ㅏ ㅗ ㅓ ㅏ ㅗ ㅓ ㅏ ㅗ ㅓ ㅏ ㅗ ㅓ ㅏ -> ㅗ ㅓ ㅏ ㅗ ㅓ ㅏ ㅗ ㅓ ㅏ ㅗ ㅓ ㅏ ㅗ ㅓ ㅏ
호 러 아 호 러 아 호 러 아 호 러 아 호 러 아 -> 호 러 아 호 러 아 호 러 아 호 러 아 호 러 아

ㄴ ㄴ ㄴ ㄴ ㄴ ㄴ ㄴ ㄴ ㄴ ㄴ ㄴ ㄴ ㄴ ㄴ ㄴ -> ㄴ ㄴ ㄴ ㄴ ㄴ ㄴ ㄴ ㄴ ㄴ ㄴ ㄴ ㄴ ㄴ ㄴ ㄴ
ㅁ ㅁ ㅁ ㅁ ㅁ ㅁ ㅁ ㅁ ㅁ ㅁ ㅁ ㅁ ㅁ ㅁ ㅁ -> ㅁ ㅁ ㅁ ㅁ ㅁ ㅁ ㅁ ㅁ ㅁ ㅁ ㅁ ㅁ ㅁ ㅁ ㅁ
ㅜ ㅜ ㅜ ㅜ ㅜ ㅜ ㅜ ㅜ ㅜ ㅜ ㅜ ㅜ ㅜ ㅜ ㅜ -> ㅜ ㅜ ㅜ ㅜ ㅜ ㅜ ㅜ ㅜ ㅜ ㅜ ㅜ ㅜ ㅜ ㅜ ㅜ
ㅠ ㅠ ㅠ ㅠ ㅠ ㅠ ㅠ ㅠ ㅠ ㅠ ㅠ ㅠ ㅠ ㅠ ㅠ -> ㅠ ㅠ ㅠ ㅠ ㅠ ㅠ ㅠ ㅠ ㅠ ㅠ ㅠ ㅠ ㅠ ㅠ ㅠ
ㅠ ㅜ ㅠ ㅜ ㅠ ㅜ ㅠ ㅜ ㅠ ㅜ ㅠ ㅜ ㅠ ㅜ -> ㅠ ㅜ ㅠ ㅜ ㅠ ㅜ ㅠ ㅜ ㅠ ㅜ ㅠ ㅜ ㅠ ㅜ
뮤 뮤 뮤 뮤 뮤 뮤 뮤 뮤 뮤 뮤 뮤 뮤 뮤 뮤 -> 뮤 뮤 뮤 뮤 뮤 뮤 뮤 뮤 뮤 뮤 뮤 뮤 뮤 뮤
눈 눈 눈 눈 눈 눈 눈 눈 눈 눈 눈 눈 눈 눈 -> 눈 눈 눈 눈 눈 눈 눈 눈 눈 눈 눈 눈 눈 눈
물 물 물 물 물 물 물 물 물 물 물 물 물 물 -> 물 물 물 물 물 물 물 물 물 물 물 물 물 물
넘 넘 넘 넘 넘 넘 넘 넘 넘 넘 넘 넘 넘 넘 -> 넘 넘 넘 넘 넘 넘 넘 넘 넘 넘 넘 넘 넘 넘

ㅣ ㅣ ㅣ ㅣ ㅣ ㅣ ㅣ ㅣ ㅣ ㅣ ㅣ ㅣ ㅣ ㅣ ㅣ -> ㅣ ㅣ ㅣ ㅣ ㅣ ㅣ ㅣ ㅣ ㅣ ㅣ ㅣ ㅣ ㅣ ㅣ ㅣ
ㅡ ㅡ ㅡ ㅡ ㅡ ㅡ ㅡ ㅡ ㅡ ㅡ ㅡ ㅡ ㅡ ㅡ ㅡ -> ㅡ ㅡ ㅡ ㅡ ㅡ ㅡ ㅡ ㅡ ㅡ ㅡ ㅡ ㅡ ㅡ ㅡ ㅡ
ㅢ ㅢ ㅢ ㅢ ㅢ ㅢ ㅢ ㅢ ㅢ ㅢ ㅢ ㅢ ㅢ ㅢ ㅢ -> ㅢ ㅢ ㅢ ㅢ ㅢ ㅢ ㅢ ㅢ ㅢ ㅢ ㅢ ㅢ ㅢ ㅢ ㅢ
ㅅ ㅅ ㅅ ㅅ ㅅ ㅅ ㅅ ㅅ ㅅ ㅅ ㅅ ㅅ ㅅ ㅅ ㅅ -> ㅅ ㅅ ㅅ ㅅ ㅅ ㅅ ㅅ ㅅ ㅅ ㅅ ㅅ ㅅ ㅅ ㅅ ㅅ
ㅛ ㅛ ㅛ ㅛ ㅛ ㅛ ㅛ ㅛ ㅛ ㅛ ㅛ ㅛ ㅛ ㅛ ㅛ -> ㅛ ㅛ ㅛ ㅛ ㅛ ㅛ ㅛ ㅛ ㅛ ㅛ ㅛ ㅛ ㅛ ㅛ ㅛ
ㅅ ㅛ ㅅ ㅛ ㅅ ㅛ ㅅ ㅛ ㅅ ㅛ ㅅ ㅛ ㅅ ㅛ ㅅ -> ㅅ ㅛ ㅅ ㅛ ㅅ ㅛ ㅅ ㅛ ㅅ ㅛ ㅅ ㅛ ㅅ ㅛ ㅅ
쇼 쇼 쇼 쇼 쇼 쇼 쇼 쇼 쇼 쇼 쇼 쇼 쇼 쇼 쇼 -> 쇼 쇼 쇼 쇼 쇼 쇼 쇼 쇼 쇼 쇼 쇼 쇼 쇼 쇼 쇼
ㄱ ㄱ ㄱ ㄱ ㄱ ㄱ ㄱ ㄱ ㄱ ㄱ ㄱ ㄱ ㄱ ㄱ ㄱ -> ㄱ ㄱ ㄱ ㄱ ㄱ ㄱ ㄱ ㄱ ㄱ ㄱ ㄱ ㄱ ㄱ ㄱ ㄱ
ㅕ ㅕ ㅕ ㅕ ㅕ ㅕ ㅕ ㅕ ㅕ ㅕ ㅕ ㅕ ㅕ ㅕ ㅕ -> ㅕ ㅕ ㅕ ㅕ ㅕ ㅕ ㅕ ㅕ ㅕ ㅕ ㅕ ㅕ ㅕ ㅕ ㅕ
ㅕ ㅓ ㅕ ㅓ ㅕ ㅓ ㅕ ㅓ ㅕ ㅓ ㅕ ㅓ ㅕ ㅓ ㅕ ㅓ -> ㅕ ㅓ ㅕ ㅓ ㅕ ㅓ ㅕ ㅓ ㅕ ㅓ ㅕ ㅓ ㅕ ㅓ ㅕ ㅓ
그 그 그 그 그 그 그 그 그 그 그 그 그 그 그 그 -> 그 그 그 그 그 그 그 그 그 그 그 그 그 그 그 그
ㅏ ㅑ ㅏ ㅑ ㅏ ㅑ ㅏ ㅑ ㅏ ㅑ ㅏ ㅑ ㅏ ㅑ ㅏ ㅑ -> ㅏ ㅑ ㅏ ㅑ ㅏ ㅑ ㅏ ㅑ ㅏ ㅑ ㅏ ㅑ ㅏ ㅑ ㅏ ㅑ
ㅛ ㅗ ㅛ ㅗ ㅛ ㅗ ㅛ ㅗ ㅛ ㅗ ㅛ ㅗ ㅛ ㅗ ㅛ ㅗ -> ㅛ ㅗ ㅛ ㅗ ㅛ ㅗ ㅛ ㅗ ㅛ ㅗ ㅛ ㅗ ㅛ ㅗ ㅛ ㅗ
샤 겨 샤 겨 샤 겨 샤 겨 샤 겨 샤 겨 샤 겨 샤 겨 -> 샤 겨 샤 겨 샤 겨 샤 겨 샤 겨 샤 겨 샤 겨 샤 겨

ㅐ ㅐ ㅐ ㅐ ㅐ ㅐ ㅐ ㅐ ㅐ ㅐ ㅐ ㅐ ㅐ ㅐ ㅐ ㅐ -> ㅐ ㅐ ㅐ ㅐ ㅐ ㅐ ㅐ ㅐ ㅐ ㅐ ㅐ ㅐ ㅐ ㅐ ㅐ ㅐ
ㅔ ㅔ ㅔ ㅔ ㅔ ㅔ ㅔ ㅔ ㅔ ㅔ ㅔ ㅔ ㅔ ㅔ ㅔ ㅔ -> ㅔ ㅔ ㅔ ㅔ ㅔ ㅔ ㅔ ㅔ ㅔ ㅔ ㅔ ㅔ ㅔ ㅔ ㅔ ㅔ
ㅒ ㅒ ㅒ ㅒ ㅒ ㅒ ㅒ ㅒ ㅒ ㅒ ㅒ ㅒ ㅒ ㅒ ㅒ ㅒ -> ㅒ ㅒ ㅒ ㅒ ㅒ ㅒ ㅒ ㅒ ㅒ ㅒ ㅒ ㅒ ㅒ ㅒ ㅒ ㅒ
ㅖ ㅖ ㅖ ㅖ ㅖ ㅖ ㅖ ㅖ ㅖ ㅖ ㅖ ㅖ ㅖ ㅖ ㅖ ㅖ -> ㅖ ㅖ ㅖ ㅖ ㅖ ㅖ ㅖ ㅖ ㅖ ㅖ ㅖ ㅖ ㅖ ㅖ ㅖ ㅖ
ㅐ ㅒ ㅐ ㅒ ㅐ ㅒ ㅐ ㅒ ㅐ ㅒ ㅐ ㅒ ㅐ ㅒ ㅐ ㅒ -> ㅐ ㅒ ㅐ ㅒ ㅐ ㅒ ㅐ ㅒ ㅐ ㅒ ㅐ ㅒ ㅐ ㅒ ㅐ ㅒ
ㅔ ㅖ ㅔ ㅖ ㅔ ㅖ ㅔ ㅖ ㅔ ㅖ ㅔ ㅖ ㅔ ㅖ ㅔ ㅖ -> ㅔ ㅖ ㅔ ㅖ ㅔ ㅖ ㅔ ㅖ ㅔ ㅖ ㅔ ㅖ ㅔ ㅖ ㅔ ㅖ
ㄷ ㄷ ㄷ ㄷ ㄷ ㄷ ㄷ ㄷ ㄷ ㄷ ㄷ ㄷ ㄷ ㄷ ㄷ ㄷ -> ㄷ ㄷ ㄷ ㄷ ㄷ ㄷ ㄷ ㄷ ㄷ ㄷ ㄷ ㄷ ㄷ ㄷ ㄷ ㄷ
대 데 대 데 대 데 대 데 대 데 대 데 대 데 대 데 -> 대 데 대 데 대 데 대 데 대 데 대 데 대 데 대 데
ㅈ ㅈ ㅈ ㅈ ㅈ ㅈ ㅈ ㅈ ㅈ ㅈ ㅈ ㅈ ㅈ ㅈ ㅈ ㅈ -> ㅈ ㅈ ㅈ ㅈ ㅈ ㅈ ㅈ ㅈ ㅈ ㅈ ㅈ ㅈ ㅈ ㅈ ㅈ ㅈ
저 저 저 저 저 저 저 저 저 저 저 저 저 저 저 저 -> 저 저 저 저 저 저 저 저 저 저 저 저 저 저 저 저
ㅂ ㅂ ㅂ ㅂ ㅂ ㅂ ㅂ ㅂ ㅂ ㅂ ㅂ ㅂ ㅂ ㅂ ㅂ ㅂ -> ㅂ ㅂ ㅂ ㅂ ㅂ ㅂ ㅂ ㅂ ㅂ ㅂ ㅂ ㅂ ㅂ ㅂ ㅂ ㅂ
밥 밥 밥 밥 밥 밥 밥 밥 밥 밥 밥 밥 밥 밥 밥 밥 -> 밥 밥 밥 밥 밥 밥 밥 밥 밥 밥 밥 밥 밥 밥 밥 밥

ㅋ ㅋ ㅋ ㅋ ㅋ ㅋ ㅋ ㅋ ㅋ ㅋ ㅋ ㅋ ㅋ ㅋ ㅋ ㅋ -> ㅋ ㅋ ㅋ ㅋ ㅋ ㅋ ㅋ ㅋ ㅋ ㅋ ㅋ ㅋ ㅋ ㅋ ㅋ ㅋ
ㅌ ㅌ ㅌ ㅌ ㅌ ㅌ ㅌ ㅌ ㅌ ㅌ ㅌ ㅌ ㅌ ㅌ ㅌ ㅌ -> ㅌ ㅌ ㅌ ㅌ ㅌ ㅌ ㅌ ㅌ ㅌ ㅌ ㅌ ㅌ ㅌ ㅌ ㅌ ㅌ
ㅊ ㅊ ㅊ ㅊ ㅊ ㅊ ㅊ ㅊ ㅊ ㅊ ㅊ ㅊ ㅊ ㅊ ㅊ ㅊ -> ㅊ ㅊ ㅊ ㅊ ㅊ ㅊ ㅊ ㅊ ㅊ ㅊ ㅊ ㅊ ㅊ ㅊ ㅊ ㅊ
ㅍ ㅍ ㅍ ㅍ ㅍ ㅍ ㅍ ㅍ ㅍ ㅍ ㅍ ㅍ ㅍ ㅍ ㅍ ㅍ -> ㅍ ㅍ ㅍ ㅍ ㅍ ㅍ ㅍ ㅍ ㅍ ㅍ ㅍ ㅍ ㅍ ㅍ ㅍ ㅍ