# Formy bezosobowe

# I
pisać -> pisano
dawać -> dawano
zrobić -> zrobiono
widzieć -> widziano
ukryć -> ukryto
zacząć -> zaczęto
chcieć -> chciano
przetłumaczyć -> przetłumaczono
kupić -> kupiono
zjeść -> zjedzono
umyć -> umyto
zmienić -> zmieniono
wiedzieć -> wiedziano
znaleźć -> znaleziono
rysować -> rysowano

# II
oglądać -> oglądano
pić -> pito
zamknąć -> zamknięto
sprawdzić -> sprawdzono
myśleć -> myślano
wyczyścić -> wyczyszczono
obawiać się -> obawiano się
zmierzyć -> zmierzono
szyć -> szyto
pożyczyć -> pożyczono
zatruć -> zatruto
policzyć -> policzono
wziąć -> wzięto
jeździć -> jeżdżono

# III
We Francji ludzie jadają ślimaki. -> We Francji jada się ślimaki.
Przed Świętami wszyscy kupują więcej jedzenia. -> Przed Świętami kupuje się więcej jedzenia.
Na lotnisku celnicy kontrolują bagaże podróżnych. -> Na lotnisku kontroluje się bagaże podróżnych.
Jak co roku, dyrekcja organizuje w Domu Kultury różne kursy. -> Jak co roku, w Domu Kultury organizuje się różne kursy.
W ostatnich latach ludzie piją coraz więcej kawy. -> W ostatnich latach pije się więcej kawy.
Na całym świecie policja ściga przestępców. -> Na całym świecie ściga się przestępców.
W karnawale ludzie powinni dużo tańczyć. -> W karnawale powinno się dużo tańczyć.
Na wiosnę kobiety bardzo często zmieniają fryzury. -> Na wiosnę bardzo często zmienia się fryzury.
W Szwajcarii producenci produkują najlepsze zegarki. -> W Szwajcarii producuje się najlepsze zegarki.
Wszędzie wszyscy oglądzją seriale telewizyjne. -> Wszędzie ogląda się seriale telewizyjne.
W lecie ludzie jedzą więcej lodów. -> W lecie je się więcej lodów.
Na ogół wszyscy pamiętają o swoich własnych urodzinach. -> Na ogół pamięta się o swoich własnych urodzinach.
Na całym świecie konstruktorzy myślą o nowych rozwiązaniach technicznych samochodów. -> Na całym świecie myśli się o nowych rozwiązaniach technicznych samochodów.
Firmy sprzedają coraz więcej komputerów. -> Sprzedaje się coraz więcej komputerów.
W Holandii ludzie dużo jeżdżą na rowerach. -> W Holandii dużo jeździ się na rowerach.
